###############################
A              #     #        #
#######  ####  ####  #  #######
#     #  #           #        #
#  #  ####  #  #  ####  #######
#  #     #  #  #  #     #     #
#  ####  #  ####  #  #  ####  #
#  #  #  #     #     #  #     #
#  #  #  #  ####  #  #  ####  #
#     #  #  #  #  #  #        #
#  ####  #  #  #######  #######
#     #              #        #
####  ####  ################  #
#     #              #     #  #
#######  ####  ####  #  ####  #
#     #     #     #     #     #
####  ####  ####  ##########  #
#        #  #        #     #  #
#  ####  ####  #######  ####  #
#  #                 #        B
###############################