###########################
#      #      #    #####B##
# ######## #######     # ##
#   ##          ## ### # ##
# # ### #### ## #  ##### ##
###       #   ####       ##
#   ## ######## ## ### ####
# # ##          ##       ##
# # #  ### ####### ########
# #### #    #      ##    ##
#    # ###### ####### ## ##
###  # #              #  ##
#   ## ## ### ## ####### ##
# ###  #### ####    #    ##
# # # ##         #### #####
# # #    ############     #
#   ########   #    ##### #
###          # ####       #
#A  ######## #      #### ##
###########################