###############################
#        #        #           #
#######  #  ####  ####  #######
#        #     #  #  #        #
#  ####  #  #  ####  #  #######
#  #        #     #           #
#  #  ####  ####  ####  #  #  #
#  #     #  #     #     #  #  #
####  ##########  #  #  ####  #
#     #  #  #   A    #  #     #
#######  #  #  ####  #######  #
#B    #  #  #  #     #  #  #  #
####  #  #  ####  #  #  #  ####
#           #  #  #     #     #
#  #  ####  #  #  ####  #  ####
#  #     #  #        #  #     #
#  #  #######  #######  ####  #
#  #  #     #     #        #  #
#  #  #  ####  #  #  #  ####  #
#  #           #  #  #        #
###############################