###########################
#      #           #####B##
# ######## #######     # ##
#   ##          ## ### # ##
# # ######## ## #  ##### ##
###       #   ####       ##
#   ## ######## ## ### ####
# # ##          ##       ##
# # #  ### ####### ########
# #### #    #      ##    ##
#    # ###### ####### ## ##
###  # #              #  ##
#   ## ## ### ## ####### ##
# ###  #### ####    #    ##
# # # ##         #### #####
# # #    ############     #
#   ########   #    ##### #
###          # ####       #
#A  ######## #      #### ##
###########################