###############################
#A       #  #     #           #
####  ####  #  #  ##########  #
#        #  #  #  #           #
####  #  #  ####  #######  #  #
#     #        #           #  #
#  #  ####  ##########  ####  #
#  #     #  #     #     #     #
####  #######  ####  #  #  #  #
#           #     #  #  #  #  #
#  #######  #  #  #  #######  #
#        #     #  #        #  #
#  #######  ####  #  ####  ####
#        #  #        #        #
#  #############  #  #  ####  #
#  #  #  #     #  #  #  #     #
#  #  #  #  ##########  ####  #
#     #  #     #     #     #  #
####  #  #  ####  #  ####  #  #
#           #     #        # B#
###############################