##################################
#                               B#
# ############################## #
# #            #   #   #   #   # #
# ####### #### # # # # # # # # # #
#         #    # # # # # # # # # #
######### # #### # # # # # # # # #
#A        #      #   #   #   #   #
##################################